WE textures/wood3.xpm
SO textures/greybrick7.xpm 
EA textures/wood3.xpm
NO textures/greybrick7.xpm

F 255,0,0
C 217,234,253

111111111111111111111111111
100000000000000000000000001
100000000000N00000000000001
100000000000000000000000001
100000000000000000000000001
111111111111111111111111111
