WE textures/wood3.xpm
SO textures/greybrick7.xpm 
EA textures/wood3.xpm
NO textures/greybrick7.xpm

F 255,0,0
C 217,234,253

1111111111111111111
 10000000000000001
  100000000000001
   1000000000001
    10000000001
     100000001
      1000001
       10001
        1S1
         1
