NO ./path_to_the_north_texture



SO ./path_to_the_south_texture



WE ./path_to_the_west_texture

EA ./path_to_the_east_texture
F 220,100,0


C 225,30,0




1111111111111111111111111
1N00000000000000000000001
1111110000000111111100001
1110000000000001110000011
1100000000000011111000111
1111000000000000000000001
1111000000000001110000011
1111111110000000100000111
1111000000000011001101111
1111111111110000000000111
1111111111111111111111111