NO textures/greybrick7.xpm              
SO textures/greybrick7.xpm
WE textures/wood3.xpm
EA textures/wood3.xpm
C 217,234,253
F 155,118,83



111111111111111111111111111
100000000011000000000000111
10000000011100000E000000111
10010000000000000000000111111111
111111111011000001110000000000001
100000000011000001110111111111111
11110111111111011100000010001
11110111011111011101010010001
11000000110101011100000010001
10000000000000001100000010001
10000000000000001101010010001
110000011101010111101111000111
11110111 1110101 101111010001
11111111 1111111 111111111111