NO ./path_to_the_north_texture



SO ./path_to_the_south_texture



WE ./path_to_the_west_texture

EA ./path_to_the_east_texture
F 220,100,0


C 225,30,0




1111  1111111111111111111111
111111111000000111111111111
111111001000000N1000000001111
11111111101100011111000001111111
100000000011000001110111100011111
11110111111111011100000010001
11110111111111011101010010001
11000100110101011100000010001
10001 100000000001100000010001
100001001100000001101010010001
11000001 11010111110111100111
11110111 1110101 101111010001
11111111 1111111 111111111111